tyhat->that
repeteadly->repeatedly
adquires->acquires
subterranian->subterranean
passerbys->passersby
enviornmentalist->environmentalist
naturually->naturally
signfies->signifies
tendacy->tendency
sedereal->sidereal
Habsbourg->Habsburg
exculsivly->exclusively
premeire->premiere
poulations->populations
possibilty->possibility
stuggling->struggling
shiped->shipped
Palistian->Palestinian
satelites->satellites
centruies->centuries
dissapearing->disappearing
acommodate->accommodate
flourine->fluorine
godess->goddess
nutritents->nutrients
encylopedia->encyclopedia
spermatozoan->spermatozoon
staion->station
seinor->senior
cassawory->cassowary
perade->parade
historicians->historians
lerans->learns
continueing->continuing
filiament->filament
compability->compatibility
attemting->attempting
fianite->finite
explaination->explanation
equivelant->equivalent
initation->initiation
auxilliaries->auxiliaries
propotions->proportions
prevelant->prevalent
repetion->repetition
pinnaple->pineapple
iresistible->irresistible
stuctured->structured
nkwo->know
repblics->republics
crtical->critical
additinally->additionally
creaeted->created
persuits->pursuits
transcendant->transcendent
epsiode->episode
disover->discover
inclreased->increased
sufferred->suffered
nothern->northern
harassement->harassment
childbird->childbirth
sicne->since
diamons->diamonds
obstancles->obstacles
nessasarily->necessarily
concidering->considering
distruction->destruction
exibition->exhibition
catergorize->categorize
racaus->raucous
buisness->business
somtimes->sometimes
youseff->yousef
critereon->criterion
journies->journeys
alligned->aligned
beautyfull->beautiful
particularily->particularly
advertisment->advertisement
immitated->imitated
tahn->than
presedential->presidential
hvaing->having
confidental->confidential
acheive->achieve
Morrisette->Morissette
occurances->occurrences
dissobediant->disobedient
encouraing->encouraging
enviromentally->environmentally
potrayed->portrayed
subsidary->subsidiary
Sanhedrim->Sanhedrin
sacrifical->sacrificial
UnitesStates->UnitedStates
chuch->church
issueing->issuing
imprioned->imprisoned
technitian->technician
assualted->assaulted
dispicable->despicable
diferrent->different
desintegrated->disintegrated
Britian->Britain
agred->agreed
independantly->independently
insectiverous->insectivorous
knowlege->knowledge
sherif->sheriff
aledges->alleges
intutive->intuitive
heroe->hero
adressed->addressed
ancilliary->ancillary
drnik->drink
devided->divided
improvision->improvisation
collonade->colonnade
obssessed->obsessed
contempory->contemporary
catergorized->categorized
refect->reflect
twon->town
catterpilars->caterpillars
congradulations->congratulations
aready->already
masterbation->masturbation
guerrilas->guerrillas
eiter->either
spriritual->spiritual
appartments->apartments
archetects->architects
Sacremento->Sacramento
curcuit->circuit
insitution->institution
contamporaries->contemporaries
otehr->other
refernce->reference
thsi->this
dupicate->duplicate
warrent->warrant
hydropilic->hydrophilic
hierachical->hierarchical
knifes->knives
tommorrow->tomorrow
importamt->important
descision->decision
nestin->nesting
priviledges->privileges
postion->position
enduce->induce
helpped->helped
useage->usage
rhymme->rhyme
prooved->proved
weas->was
posseses->possesses
lvoe->love
comemmorates->commemorates
usally->usually
publishor->publisher
hierarcical->hierarchical
reciever->receiver
ressembled->resembled
Massachussets->Massachusetts
Portugese->Portuguese
theives->thieves
casulaties->casualties
catepillar->caterpillar
inevitible->inevitable
realyl->really
aquire->acquire
wheras->whereas
descuss->discuss
physicaly->physically
unconciousness->unconsciousness
sandwhich->sandwich
exept->except
anbd->and
decendants->descendants
proccessing->processing
absail->abseil
oppositition->opposition
unwarrented->unwarranted
recomend->recommend
changable->changeable
ninty->ninety
indespensable->indispensable
unilatreally->unilaterally
propmted->prompted
amoung->among
maintainence->maintenance
imagenary->imaginary
manufature->manufacture
contraversy->controversy
inadiquate->inadequate
eceonomy->economy
sypmtoms->symptoms
exemple->example
holliday->holiday
doulbe->double
carniverous->carnivorous
mysef->myself
ocuntries->countries
devels->delves
perhasp->perhaps
benificial->beneficial
controvercial->controversial
ahev->have
indispensible->indispensable
constanly->constantly
writen->written
devolopement->development
enameld->enameled
simultanously->simultaneously
Malcom->Malcolm
uncertainity->uncertainty
intervines->intervenes
permenantly->permanently
allegely->allegedly
governer->governor
rabinnical->rabbinical
instutions->intuitions
iunior->junior
oppenly->openly
infrantryman->infantryman
volounteered->volunteered
succesfuly->successfully
documenatry->documentary
recompence->recompense
piblisher->publisher
veyr->very
sterotypes->stereotypes
neccessarily->necessarily
repblic->republic
sergent->sergeant
assosication->assassination
hertzs->hertz
transesxuals->transsexuals
expell->expel
sponser->sponsor
releive->relieve
possably->possibly
messanger->messenger
resembes->resembles
attitide->attitude
preperations->preparations
intial->initial
pomegranite->pomegranate
severeal->several
engagment->engagement
tyranies->tyrannies
probablistic->probabilistic
assassintation->assassination
vegitables->vegetables
thta->that
contendor->contender
entitity->entity
disobediant->disobedient
feromone->pheromone
emision->emission
percepted->perceived
distructive->destructive
unplease->displease
praries->prairies
recievers->receivers
recieving->receiving
donig->doing
pamflet->pamphlet
inappropiate->inappropriate
insurence->insurance
curriculem->curriculum
unkown->unknown
refering->referring
estabishes->establishes
taxanomic->taxonomic
thyat->that
avalable->available
atheneans->athenians
owudl->would
ocasion->occasion
rythim->rhythm
priveleges->privileges
harras->harass
strenghened->strengthened
pich->pitch
sattelite->satellite
differnt->different
mathematicas->mathematics
republian->republican
typicaly->typically
prominance->prominence
charactors->characters
substracted->subtracted
suppy->supply
benifit->benefit
chemcial->chemical
valetta->valletta
consttruction->construction
competant->competent
possiblity->possibility
triguered->triggered
liuke->like
surrepetitious->surreptitious
bewteen->between
aquainted->acquainted
destablized->destabilized
independece->independence
republians->republicans
purposedly->purposely
contamporary->contemporary
negotation->negotiation
gropu->group
truely->truly
galvinized->galvanized
admited->admitted
Blitzkreig->Blitzkrieg
garantee->guarantee
noteable->notable
penisular->peninsular
polutes->pollutes
dicovers->discovers
restauraunt->restaurant
endig->ending
surprizing->surprising
exinct->extinct
debateable->debatable
sevice->service
choosen->chosen
discribing->describing
desigining->designing
sucess->success
marketting->marketing
vegitable->vegetable
transporation->transportation
extremly->extremely
spectum->spectrum
reccomendations->recommendations
assemple->assemble
individualy->individually
strikely->strikingly
ressemblence->resemblance
pretection->protection
headquaters->headquarters
sargeant->sergeant
plausable->plausible
definance->defiance
unanymous->unanimous
arangement->arrangement
emmisarry->emissary
furuther->further
miscellanous->miscellaneous
polical->political
equivilant->equivalent
occassion->occasion
acquaintences->acquaintances
busines->business
marrtyred->martyred
prefered->preferred
algebraical->algebraic
predicatble->predictable
referencs->references
combanations->combinations
humoural->humoral
acused->accused
spontanous->spontaneous
broacasted->broadcast
inprisonment->imprisonment
disatisfied->dissatisfied
sacreligious->sacrilegious
govement->government
inofficial->unofficial
storeis->stories
particuarly->particularly
persistant->persistent
settlment->settlement
colonizators->colonizers
baceause->because
mysogynist->misogynist
commisions->commissions
enthusiatic->enthusiastic
consideres->considered
reveral->reversal
liek->like
provisonal->provisional
glight->flight
campains->campaigns
vasall->vassal
aggreement->agreement
aggresive->aggressive
agression->aggression
suppoed->supposed
ficticious->fictitious
biginning->beginning
phenomenonly->phenomenally
impecabbly->impeccably
govornment->government
unecessary->unnecessary
tast->taste
authorithy->authority
muscial->musical
rocord->record
quantaty->quantity
upgradded->upgraded
excell->excel
exagerates->exaggerates
superintendant->superintendent
rininging->ringing
orded->ordered
incramentally->incrementally
recieves->receives
reacing->reaching
fertily->fertility
carismatic->charismatic
senarios->scenarios
comparision->comparison
wtih->with
minature->miniature
adbandon->abandon
adavanced->advanced
repulic->republic
volounteering->volunteering
configureable->configurable
perfomers->performers
imediately->immediately
howver->however
alchol->alcohol
annoint->anoint
achivement->achievement
intercontinential->intercontinental
acheivment->achievement
threatend->threatened
movei->movie
misdemenors->misdemeanors
decideable->decidable
lukid->likud
asteriod->asteroid
dominent->dominant
assasinated->assassinated
suplimented->supplemented
bergamont->bergamot
instade->instead
triology->trilogy
octohedron->octahedron
tepmorarily->temporarily
recomends->recommends
unsuprising->unsurprising
markes->marks
approximitely->approximately
statememts->statements
catapillers->caterpillars
agrieved->aggrieved
oponent->opponent
dipthongs->diphthongs
evenhtually->eventually
beng->being
adequit->adequate
assoicate->associate
colelctive->collective
reccuring->recurring
ideosyncratic->idiosyncratic
necesary->necessary
eletricity->electricity
symetrically->symmetrically
religously->religiously
condidtions->conditions
reversable->reversible
Godounov->Godunov
extraterrestial->extraterrestrial
hieroglphs->hieroglyphs
horrifing->horrifying
aircrafts'->aircraft's
consulant->consultant
allegience->allegiance
muscician->musician
exressed->expressed
unplesant->unpleasant
unavailible->unavailable
consituencies->constituencies
constituants->constituents
potatos->potatoes
consumate->consummate
tenacle->tentacle
synonomous->synonymous
attemted->attempted
nuturing->nurturing
noticable->noticeable
authoritive->authoritative
collosal->colossal
eratic->erratic
sacrafice->sacrifice
taht->that
htink->think
rediculous->ridiculous
afficionados->aficionados
aeriel->aerial
loev->love
synagouge->synagogue
consonents->consonants
optomism->optimism
abundacies->abundances
hygeine->hygiene
delagates->delegates
prarie->prairie
indisputibly->indisputably
asume->assume
Eurpean->European
becasue->because
abondoned->abandoned
cmo->com
misterious->mysterious
comming->coming
protrayed->portrayed
dispenced->dispensed
listners->listeners
maintance->maintenance
Guatamala->Guatemala
acheivements->achievements
restaraunteurs->restaurateurs
practicioners->practitioners
hting->thing
decidely->decidedly
doccumented->documented
compulsary->compulsory
publisherr->publisher
bcak->back
extraterrestials->extraterrestrials
desintegration->disintegration
omiting->omitting
symmetral->symmetric
magnificient->magnificent
ecomonic->economic
satrically->satirically
occassionally->occasionally
vaguaries->vagaries
consitutional->constitutional
acheives->achieves
whith->with
cartilidge->cartilage
aeriels->aerials
imagin->imagine
possibile->possible
archtype->archetype
dissobediance->disobedience
whants->wants
enviorments->environments
caterpilar->caterpillar
activites->activities
milennium->millennium
unuseable->unusable
Phonecian->Phoenecian
aroud->around
tath->that
scientifc->scientific
reportadly->reportedly
wasnt->wasn't
commemerative->commemorative
survivied->survived
forhead->forehead
diablical->diabolical
thikn->think
aniversary->anniversary
resturant->restaurant
sucessfull->successful
paticular->particular
pubisher->publisher
facilites->facilities
millenium->millennium
levetated->levitated
distingishes->distinguishes
vengence->vengeance
occour->occur
achievments->achievements
interelated->interrelated
monolite->monolithic
engieneer->engineer
agian->again
siginificant->significant
unsuccesful->unsuccessful
befoer->before
consdiered->considered
absense->absence
stirrs->stirs
acceptible->acceptable
miliraty->military
witht->with
emprisoned->imprisoned
insitutions->institutions
yuo->you
insensative->insensitive
anthromorphization->anthropomorphization
circumsicion->circumcision
recivership->receivership
constatn->constant
atempting->attempting
inbalanced->imbalanced
annointing->anointing
translater->translator
pblisher->publisher
algoritm->algorithm
immidiately->immediately
criticists->critics
unforgetable->unforgettable
internation->international
asthetic->aesthetic
competive->competitive
grammer->grammar
aquiantance->acquaintance
surronded->surrounded
willingless->willingness
persue->pursue
immitate->imitate
alowing->allowing
siezure->seizure
exicting->exciting
succeded->succeeded
Nullabour->Nullarbor
communites->communities
accomadating->accommodating
acquiantence->acquaintance
purpotedly->purportedly
correspondant->correspondent
inproving->improving
possition->position
rehersal->rehearsal
cerimonies->ceremonies
asssassans->assassins
repulics->republics
succesion->succession
munbers->numbers
lmits->limits
seguoys->segues
creche->crèche
gurantee->guarantee
Guilio->Giulio
slippy->slippery
wih->with
startegic->strategic
areodynamics->aerodynamics
omision->omission
indefineable->undefinable
inctroduced->introduced
arrangments->arrangements
amoungst->amongst
wierd->weird
socities->societies
curch->church
interrugum->interregnum
execising->exercising
disapointing->disappointing
ocassionally->occasionally
addionally->additionally
tradtionally->traditionally
convertables->convertibles
candadate->candidate
unconvential->unconventional
architechturally->architecturally
morroco->morocco
yatch->yacht
goverment->government
commonweath->commonwealth
incuding->including
santioned->sanctioned
heridity->heredity
charaterized->characterized
mercentile->mercantile
referrences->references
aleged->alleged
analogeous->analogous
millioniare->millionaire
hwile->while
ingreediants->ingredients
incidently->incidentally
epidsodes->episodes
relatiopnship->relationship
efficency->efficiency
representives->representatives
futher->further
publisehr->publisher
unsuccessfull->unsuccessful
wresters->wrestlers
possiblility->possibility
accomadate->accommodate
doccument->document
similiarity->similarity
efficently->efficiently
sucessive->successive
presumabely->presumably
anonimity->anonymity
releived->relieved
gratuitious->gratuitous
timne->time
errupted->erupted
trancendent->transcendent
acccused->accused
repsectively->respectively
jouney->journey
freindly->friendly
potrait->portrait
asthetically->aesthetically
campain->campaign
alomst->almost
irelevent->irrelevant
excecuted->executed
beleif->belief
eratically->erratically
portugues->Portuguese
cmoputer->computer
cahracters->characters
inlcuding->including
recided->resided
philisophy->philosophy
geometricians->geometers
minsitry->ministry
archimedian->archimedean
supressed->suppressed
moil->soil
sucesion->succession
secretery->secretary
priveliges->privileges
harrassing->harassing
subjudgation->subjugation
obstruced->obstructed
remaing->remaining
Phillippines->Philippines
parrallelly->parallelly
competative->competitive
guerrila->guerrilla
predecesors->predecessors
esential->essential
responsability->responsibility
availible->available
responisble->responsible
readmition->readmission
corridoors->corridors
transfered->transferred
inheritence->inheritance
itnroduced->introduced
membranaphone->membranophone
goverance->governance
slighly->slightly
storise->stories
spoonfulls->spoonfuls
emphsis->emphasis
suposing->supposing
sheild->shield
apperance->appearance
devestated->devastated
restaraunteur->restaurateur
remembrence->remembrance
contaiminate->contaminate
charachters->characters
consonent->consonant
ressurrection->resurrection
pubilsher->publisher
regulaion->regulation
hydropobic->hydrophobic
compatiblity->compatibility
montypic->monotypic
officals->officials
experiance->experience
incompatiblity->incompatibility
excecution->execution
occurance->occurrence
mkae->make
dissappears->disappears
claimes->claims
recieved->received
gardai->gardaí
sucide->suicide
reenforced->reinforced
strictist->strictest
avalance->avalanche
headquatered->headquartered
alchohol->alcohol
comemoretion->commemoration
aslo->also
lonley->lonely
benifits->benefits
terriory->territory
acomplish->accomplish
philosphy->philosophy
pbulisher->publisher
pratice->practice
resurecting->resurrecting
acheivments->achievements
beneficary->beneficiary
precisly->precisely
cementary->cemetery
resturaunt->restaurant
consept->concept
mudering->murdering
Tuscon->Tucson
follwoing->following
Mythraic->Mithraic
northen->northern
disricts->districts
acquiantences->acquaintances
proffesed->professed
attendence->attendance
univesities->universities
unfourtunately->unfortunately
poluted->polluted
exerpt->excerpt
libitarianisn->libertarianism
responsibilites->responsibilities
inot->into
surreptiously->surreptitiously
equippment->equipment
basicaly->basically
extentions->extensions
naturual->natural
experianced->experienced
definately->definitely
idealogy->ideology
dicovery->discovery
accordeon->accordion
refernces->references
nuculear->nuclear
betwen->between
doign->doing
alreayd->already
entaglements->entanglements
simultanous->simultaneous
Israelies->Israelis
admendment->amendment
vehicule->vehicle
fanatism->fanaticism
deterioriating->deteriorating
practioner->practitioner
Phillipines->Philippines
maltesian->Maltese
resturants->restaurants
unsuprized->unsurprised
calenders->calendars
alcoholical->alcoholic
suroundings->surroundings
requirment->requirement
agreeement->agreement
idaes->ideas
seldomly->seldom
medeival->medieval
enxt->next
poisin->poison
moeny->money
austrailian->Australian
fundametals->fundamentals
volounteer->volunteer
geometrician->geometer
familliar->familiar
excells->excels
foreward->foreword
conquerd->conquered
committe->committee
attemp->attempt
addresable->addressable
manufacturedd->manufactured
mediciney->mediciny
ommision->omission
cemetary->cemetery
jsut->just
gauranteed->guaranteed
communciation->communication
disiplined->disciplined
attendent->attendant
minstries->ministries
argubly->arguably
extremeophile->extremophile
suprising->surprising
radify->ratify
offcially->officially
statment->statement
capible->capable
strenghen->strengthen
schedual->schedule
amung->among
arround->around
ciriculum->curriculum
sucessfuly->successfully
propogate->propagate
cencus->census
regulaotrs->regulators
toke->took
sotry->story
diosese->diocese
hydogen->hydrogen
acuracy->accuracy
consorcium->consortium
milion->million
predomiantly->predominately
conived->connived
intergration->integration
seige->siege
surrundering->surrendering
generatting->generating
thrid->third
libguistics->linguistics
inadvertant->inadvertent
yeild->yield
diphtongs->diphthongs
subpecies->subspecies
visably->visibly
pwoer->power
caost->coast
faciliates->facilitates
impressario->impresario
suposes->supposes
exagerrates->exaggerates
surprize->surprise
millenial->millennial
misdameanors->misdemeanors
Rockerfeller->Rockefeller
pyscic->psychic
protocal->protocol
succedded->succeeded
extrememly->extremely
aplied->applied
embarassment->embarrassment
athiesm->atheism
alchoholic->alcoholic
flourishment->flourishing
controll->control
disobediance->disobedience
consituency->constituency
oportunity->opportunity
interchangable->interchangeable
multiplers->multipliers
salery->salary
supose->suppose
intrumental->instrumental
cxan->cyan
varient->variant
